90
8
0 0 0 0 0 1 2 0 11 0 0 1 2 0 0 0 0 1 2 0 0 0 0 0 0 0 0 0 0 0 0 0 0 0 0 0 12 0 0 0 0 0 0 14 0 0 0 3 5 7 7 6 5 7 6 31 5 6 31 31 31 31 31 31 31 31 31 31 31 31 31 31 31 31 31 31 31 31 31 31 31 31 31 31 31 31 31 31 31 31
0 1 2 0 0 9 10 0 38 0 0 9 10 12 0 0 0 9 10 0 0 0 0 0 38 0 0 0 0 0 0 0 0 0 0 0 32 33 34 0 0 32 33 33 34 0 0 3 5 7 6 31 31 5 7 6 31 31 31 31 5 6 31 31 31 31 19 17 17 17 17 17 17 17 17 17 18 31 31 31 31 31 31 31 31 31 31 31 31 31
0 9 10 0 0 0 0 0 0 0 0 0 0 38 0 0 0 0 0 0 38 0 0 0 0 0 0 0 0 0 0 0 0 0 11 0 0 0 0 0 0 0 20 0 0 0 0 3 5 7 6 31 31 31 31 31 31 5 7 6 31 31 31 31 31 5 30 30 30 2 0 0 0 0 0 15 9 17 17 17 17 17 17 17 17 17 17 17 17 17
0 0 0 0 38 0 0 0 0 0 0 0 0 0 0 0 0 13 0 0 0 0 0 0 0 0 0 0 0 0 0 0 0 32 34 0 0 0 0 0 0 1 30 2 0 0 0 3 31 31 5 6 31 31 31 5 6 31 31 31 31 31 31 31 31 31 19 17 17 10 0 0 38 0 0 14 0 20 1 2 0 0 0 0 0 11 0 13 0 0
0 0 0 0 0 0 0 0 38 0 15 0 0 0 0 0 0 38 0 0 1 2 0 0 0 0 0 0 0 0 0 0 0 0 0 0 0 11 0 0 0 3 31 4 0 0 0 3 31 31 5 6 5 6 31 31 31 31 19 17 17 17 17 18 5 6 4 0 0 0 15 0 0 0 0 35 36 36 36 37 0 0 0 35 36 36 36 37 0 0
0 0 0 0 0 20 0 0 0 0 16 1 2 0 15 0 0 0 0 0 9 10 0 0 0 0 0 0 0 0 0 0 0 0 15 0 35 36 36 37 0 3 31 4 0 0 0 3 31 31 5 6 5 6 31 31 5 6 4 0 0 0 0 3 5 6 4 0 1 2 16 0 0 0 0 3 4 0 0 0 0 0 0 3 4 0 3 4 0 0
0 0 0 0 0 38 0 1 2 0 16 9 10 0 16 0 0 1 2 0 0 0 0 0 1 2 0 0 0 0 0 0 13 0 14 0 3 31 31 4 15 3 31 4 0 0 0 3 5 6 31 31 5 7 7 7 6 31 4 0 0 0 0 3 31 31 4 11 3 4 14 0 1 2 0 3 4 0 0 1 2 0 0 3 4 0 3 4 0 0
133 34 0 0 0 0 0 9 10 0 16 0 0 0 16 0 0 9 10 0 0 0 0 0 9 10 0 0 0 0 0 0 35 36 37 0 3 31 31 4 16 3 31 4 0 0 0 3 5 7 6 31 31 31 31 31 31 5 30 30 30 30 30 30 7 7 30 30 30 30 30 30 30 30 30 30 30 2 0 3 4 0 0 3 4 0 3 4 35 36