120
8
31 31 31 5 6 31 31 31 4 0 0 0 0 0 0 0 0 0 0 0 0 0 0 0 0 0 0 0 0 0 0 0 0 0 20 0 0 0 0 0 0 0 15 0 0 0 0 0 0 0 0 0 0 0 0 0 0 0 0 0 0 13 0 0 0 0 0 0 0 0 0 0 0 0 0 9 17 17 17 17 17 17 17 17 17 17 17 17 17 10 0 0 0 0 0 0 3 4 0 3 4 15 0 0 15 3 4 0 3 4 38 0 0 3 4 0 0 0 0 0
31 31 5 6 31 31 31 31 4 0 0 11 0 0 0 0 0 0 0 0 0 0 0 0 0 0 0 13 0 0 0 0 0 32 34 0 0 0 0 0 0 0 14 0 0 0 0 0 0 0 0 0 11 0 0 0 0 0 32 33 33 34 0 0 0 0 0 0 0 0 32 34 0 0 0 0 0 0 13 0 0 0 0 0 0 0 0 12 13 0 0 0 0 11 0 0 3 4 0 3 4 14 0 0 14 3 4 0 3 4 0 0 0 3 4 0 0 0 0 0
31 31 31 5 6 19 17 18 4 0 0 38 0 0 0 0 0 0 0 0 0 0 0 0 0 0 0 38 0 0 0 0 0 0 0 0 0 0 0 0 0 35 37 0 0 0 0 0 1 30 30 30 30 30 30 2 0 0 0 0 0 0 0 0 0 38 0 0 0 15 0 0 0 0 0 0 0 35 36 36 36 36 36 36 36 36 36 36 36 36 36 36 36 37 0 0 3 4 0 35 36 36 36 36 36 36 37 0 3 4 0 0 11 3 4 0 0 0 0 0
31 31 5 6 31 4 13 3 4 0 0 0 0 0 0 12 0 0 0 0 0 32 34 0 0 0 0 0 0 0 0 0 0 0 0 0 0 1 30 30 30 30 30 30 30 30 30 30 30 6 5 7 7 6 31 4 0 0 0 0 0 0 0 0 0 0 0 0 0 16 0 0 0 0 0 0 0 3 5 6 31 5 7 6 4 0 0 0 0 0 3 5 2 0 0 0 3 4 0 3 4 0 0 0 0 3 4 0 3 4 35 36 36 36 37 0 0 0 0 0
31 31 31 5 7 30 30 30 2 0 0 0 0 0 0 35 37 0 0 0 0 0 0 15 0 0 0 0 0 0 15 0 0 32 34 0 0 3 5 6 19 17 17 17 17 17 17 17 17 18 5 7 7 6 31 4 0 0 0 0 0 0 0 0 0 0 0 0 0 14 0 0 0 38 0 0 0 3 31 31 5 6 31 31 4 0 0 11 0 0 3 5 2 0 0 0 3 4 0 3 4 0 0 15 0 3 4 0 3 4 3 4 1 7 2 0 0 12 0 0
31 31 5 6 31 31 31 31 4 0 0 0 0 0 0 0 0 0 0 0 15 0 0 16 0 0 15 0 0 0 14 0 0 0 0 0 0 3 5 6 4 0 0 0 0 0 0 0 0 3 5 7 7 6 31 4 0 15 0 0 0 0 0 0 15 0 0 0 0 38 0 0 0 0 0 0 0 3 31 5 6 31 31 31 4 0 32 33 33 34 3 5 2 0 0 0 3 4 20 3 4 0 0 16 0 35 36 36 36 36 36 37 3 5 2 0 0 32 33 33
17 17 17 17 17 17 17 17 10 0 13 0 0 32 33 33 34 0 0 0 14 0 0 14 11 0 16 1 30 30 30 30 30 30 30 30 2 3 31 31 4 0 0 20 13 0 0 0 20 3 5 7 7 6 19 10 0 14 0 0 0 0 0 0 16 0 0 0 0 0 0 0 0 0 0 0 0 3 5 6 31 31 5 6 4 0 0 0 0 0 3 5 2 15 0 35 36 36 36 36 37 0 0 16 0 0 0 0 0 0 0 0 3 31 4 13 0 0 0 0
30 30 30 30 30 30 30 2 32 33 33 34 0 0 15 0 0 0 0 32 33 33 33 33 33 34 16 3 31 31 31 31 31 31 31 31 4 3 31 31 4 0 35 36 36 37 1 30 30 30 7 7 7 7 30 30 30 30 30 30 30 30 30 2 16 0 15 0 35 36 36 36 36 36 37 0 15 3 31 31 5 7 6 31 4 0 0 0 0 0 3 5 2 16 0 0 0 0 0 0 0 0 0 16 0 0 0 0 0 15 0 0 3 5 30 8 2 0 0 0