31
9
22 4 0 0 0 0 0 0 0 0 0 0 0 1 21 21 2 0 0 0 0 0 0 0 0 0 0 0 0 0 0 0
22 4 0 0 0 0 0 0 0 23 25 0 1 21 22 22 21 2 0 0 0 0 0 0 0 0 0 0 0 0 0 0
22 4 0 0 0 0 0 0 0 0 0 0 3 22 22 22 22 4 0 0 0 0 0 0 0 0 0 0 0 0 0 0
22 4 0 0 0 0 0 0 0 0 0 0 0 3 22 22 4 0 0 0 0 0 0 0 0 0 0 0 0 0 0 0
22 4 0 0 0 0 0 23 24 25 0 0 0 3 22 22 4 0 0 0 0 0 0 0 0 0 0 0 0 0 0 0
22 4 0 23 25 0 0 0 0 0 0 0 0 3 22 22 4 0 0 0 0 0 0 0 0 0 0 0 0 0 0 0
22 4 0 0 0 0 0 0 0 0 0 1 21 21 0 0 21 21 2 0 0 0 0 0 0 0 0 0 0 0 0 0
22 4 9 0 10 0 23 24 25 0 0 3 22 22 0 0 22 22 4 0 0 0 0 0 0 0 0 0 0 0 0 0
5 21 21 21 21 21 21 21 21 21 21 21 21 21 21 21 21 21 21 21 21 21 21 21 21 21 21 21 21 21 21 21
