120
8
22 22 22 22 22 22 22 22 22 22 19 0 0 0 0 0 0 0 0 0 0 0 0 0 0 0 0 0 0 0 0 0 0 0 0 0 0 0 0 0 0 0 0 0 0 0 0 0 0 0 0 0 0 0 0 0 0 0 18 22 22 5 6 22 5 6 22 5 6 22 5 6 22 5 6 22 5 6 4 0 0 0 0 0 0 0 0 0 0 0 0 0 0 0 0 0 0 0 0 0 0 0 0 0 0 0 0 0 0 0 0 0 0 0 0 0 0 0 0 0
17 17 17 17 17 17 17 17 17 17 27 0 0 0 0 0 0 0 0 0 23 25 0 0 0 0 0 0 0 0 0 0 0 0 0 0 0 0 0 0 0 0 0 0 0 0 0 0 0 0 0 0 0 0 0 0 0 0 26 18 22 5 6 22 5 6 22 5 6 22 5 6 22 5 6 22 5 6 4 0 0 0 0 0 0 0 0 0 0 0 0 0 0 0 0 0 0 0 0 0 0 0 0 0 0 0 0 0 0 0 0 0 0 0 0 0 0 0 0 0
0 0 0 1 2 0 1 2 0 0 0 0 0 0 0 0 0 0 0 0 0 0 0 10 0 0 11 0 0 0 0 0 0 0 11 0 0 0 0 23 25 0 0 0 20 0 0 0 9 0 0 0 0 0 0 0 0 0 0 0 18 22 22 22 22 22 22 22 22 22 22 22 22 22 22 22 22 22 4 0 0 0 0 0 0 0 0 0 0 0 1 2 0 1 2 0 1 2 0 0 0 0 0 0 0 0 0 0 0 0 0 0 0 0 0 0 0 0 9 0
0 0 0 3 4 0 3 4 0 0 0 0 0 0 0 0 9 0 0 0 0 0 1 21 21 21 21 21 2 0 0 0 0 23 25 0 0 0 0 0 0 0 0 0 14 0 0 0 23 25 0 0 0 0 0 1 2 0 0 0 26 17 17 17 17 17 17 17 17 17 17 17 17 17 17 17 17 17 27 0 0 0 0 0 0 0 0 0 0 0 3 4 11 3 4 9 3 4 0 0 0 0 0 0 20 0 0 0 0 0 0 0 0 0 0 0 1 21 21 21
21 21 21 21 21 21 21 21 21 2 0 0 0 0 0 23 25 1 8 2 11 9 3 22 5 7 7 6 4 0 0 0 0 0 0 0 0 0 20 0 0 0 0 0 14 0 0 0 0 0 0 0 0 0 0 3 4 0 0 0 0 0 0 0 0 0 0 0 0 0 0 0 0 0 0 0 0 0 0 0 0 0 0 0 0 0 0 0 1 21 21 21 21 21 21 21 21 21 21 2 0 0 0 0 14 0 0 1 21 2 0 0 20 0 0 1 21 6 5 7
22 22 22 22 22 22 22 22 5 21 2 0 0 0 0 0 1 21 21 21 21 21 21 7 7 6 5 6 4 0 0 0 0 0 0 0 20 0 41 0 0 0 0 0 14 0 0 20 0 1 2 0 0 0 0 23 25 0 0 0 0 0 0 0 0 0 0 0 0 0 0 0 0 0 0 0 0 0 0 0 0 0 0 0 0 0 0 9 3 22 5 6 22 22 22 22 5 6 22 4 0 0 11 0 14 10 0 3 22 4 0 0 41 0 1 21 6 5 7 7
22 22 22 22 22 22 22 22 22 5 21 2 0 0 0 0 3 5 7 7 7 7 6 22 5 7 7 6 4 0 0 0 0 0 0 0 14 0 41 0 0 0 11 0 14 0 0 14 0 3 4 0 0 0 0 0 0 0 0 0 0 0 0 1 21 2 0 0 0 0 0 11 11 10 0 0 9 0 0 0 0 11 10 0 0 0 23 25 3 22 5 6 22 22 22 22 5 6 5 21 21 21 21 21 21 21 21 21 21 21 21 21 21 21 21 6 5 7 7 7
22 22 22 22 22 22 22 22 22 22 5 21 2 0 0 0 3 22 22 22 22 22 22 22 22 22 22 22 4 0 20 0 1 2 0 0 14 0 41 0 20 1 8 2 14 0 0 14 0 3 4 20 0 0 0 20 0 0 0 0 0 0 0 23 24 24 24 24 24 24 24 24 24 24 24 24 24 24 24 24 24 24 24 24 24 25 0 0 3 22 5 6 22 22 22 22 5 6 22 22 22 22 22 22 22 22 22 22 22 22 22 22 22 22 22 5 7 7 7 7