90
8
0 0 0 0 0 0 0 0 0 0 0 15 0 0 0 0 15 0 0 0 0 0 0 0 9 17 17 17 17 17 17 17 18 31 31 31 31 31 31 31 31 31 31 31 31 31 31 31 31 31 31 31 31 31 31 31 31 31 31 31 31 31 31 31 31 31 31 31 31 31 31 31 31 31 31 31 31 31 31 31 31 31 31 31 31 31 31 5 6 31
0 0 0 0 0 0 0 0 0 0 0 35 36 36 36 36 37 0 13 0 0 0 0 0 0 0 0 0 0 0 0 0 3 31 31 19 17 17 17 17 17 17 17 17 17 17 17 17 17 17 17 17 17 17 17 17 17 17 17 17 17 17 17 17 17 17 17 17 18 31 31 31 31 19 17 17 17 17 18 31 31 31 31 31 5 7 6 5 6 31
0 0 0 0 0 0 0 0 0 15 0 0 3 5 6 4 0 0 38 0 0 0 0 0 1 30 30 30 30 30 2 0 3 31 31 4 0 0 0 0 0 0 0 0 0 0 0 0 0 0 0 0 0 0 0 0 0 0 0 1 30 30 30 30 30 30 2 0 3 31 31 31 19 10 0 11 0 0 9 18 31 31 31 31 5 7 6 5 6 31
0 0 0 0 0 0 0 0 0 14 0 0 3 5 6 4 0 0 0 11 0 0 0 12 3 31 31 31 19 17 10 0 3 31 31 4 11 0 0 0 0 0 13 0 0 0 0 0 0 0 0 0 0 0 0 0 12 0 0 3 31 31 31 31 31 31 4 0 3 31 31 19 10 0 35 36 36 37 0 9 18 31 31 31 5 7 6 5 6 31
0 0 0 0 0 0 0 1 30 30 30 30 30 30 30 30 30 30 30 30 8 30 30 30 30 6 31 31 4 0 0 35 36 36 36 36 36 36 36 37 0 0 35 36 37 0 0 0 0 0 0 0 0 0 0 0 38 0 0 3 31 31 31 31 31 31 4 0 3 31 19 10 0 13 3 5 6 4 0 13 9 18 31 31 5 7 6 5 6 31
0 0 0 0 0 0 0 35 36 37 18 31 19 17 18 31 19 17 17 17 3 31 31 31 31 31 31 31 4 15 0 0 0 0 0 0 0 0 0 0 0 13 3 31 4 0 15 0 0 0 35 36 37 0 0 0 0 0 0 3 31 19 17 18 5 6 4 15 9 17 10 0 32 33 33 33 33 33 33 34 0 9 18 31 31 31 31 5 6 31
0 0 20 0 0 0 35 36 37 0 3 31 4 0 3 31 4 0 0 0 3 31 31 31 31 31 31 31 4 14 0 0 13 0 0 0 0 0 0 35 36 37 3 31 4 0 16 0 0 0 3 31 4 0 0 0 0 0 0 3 31 4 0 3 5 6 4 14 0 0 0 0 0 0 0 0 0 0 0 0 0 0 9 17 17 17 17 17 17 17
33 33 34 0 0 35 36 37 0 0 3 31 4 0 3 31 4 0 0 0 3 31 31 31 31 31 31 5 30 30 30 30 30 30 30 30 30 30 30 30 30 30 30 6 4 0 16 0 0 0 3 31 4 0 0 0 0 0 0 3 5 30 30 30 30 30 30 30 30 30 30 30 30 30 30 30 30 30 30 30 30 30 30 30 30 30 30 30 30 30