120
8
31 31 31 31 31 31 31 31 31 19 10 0 0 0 0 0 0 0 0 0 0 0 0 0 0 0 0 0 0 0 0 0 0 0 0 0 0 0 0 0 0 0 0 0 0 0 0 0 0 0 0 0 0 0 0 0 0 0 0 0 0 0 0 0 0 0 0 0 0 0 0 0 0 0 0 0 0 0 0 0 0 0 0 0 0 0 0 0 0 0 0 0 0 0 0 0 0 0 0 0 0 0 0 0 0 0 0 0 0 0 0 0 0 0 0 0 0 0 0 0
17 17 17 17 17 17 17 17 17 10 0 0 0 0 0 0 0 0 0 0 0 0 0 0 0 0 0 0 0 38 0 0 0 0 0 0 0 0 0 0 0 0 0 0 0 0 0 0 0 0 0 0 0 0 0 0 0 0 0 0 0 0 0 0 0 0 0 0 0 0 0 0 0 0 0 0 0 0 0 0 0 0 0 0 0 0 0 0 0 0 0 0 0 0 0 0 0 0 0 0 0 0 0 0 35 36 36 37 0 0 0 0 0 0 0 0 0 0 0 0
0 0 0 0 0 0 0 0 0 0 0 0 0 0 0 1 8 8 2 0 0 0 0 32 34 0 0 0 0 0 0 0 0 0 0 35 36 36 36 36 36 36 37 0 0 0 0 0 0 0 0 0 32 34 0 0 0 0 0 0 0 0 0 0 0 0 0 0 0 0 0 0 0 0 0 0 0 0 0 0 0 0 0 0 0 0 0 0 0 0 0 0 0 0 0 0 0 0 0 0 1 30 2 0 3 31 31 4 0 0 0 0 0 0 0 0 0 0 0 0
0 0 1 2 0 1 2 0 0 0 0 0 0 0 35 36 36 36 36 37 0 0 0 0 0 0 0 0 0 0 0 0 0 0 35 36 36 6 5 7 7 6 4 0 0 0 0 0 0 0 0 0 0 0 0 0 0 0 0 0 0 0 0 0 0 0 0 0 0 0 0 0 0 0 0 0 32 34 0 0 0 0 0 0 0 0 0 0 0 0 0 0 0 0 0 0 0 0 0 0 3 31 4 0 3 5 6 4 0 0 0 0 0 0 0 0 0 0 0 0
30 30 30 30 30 30 30 30 30 37 0 0 0 0 3 31 31 31 31 4 0 0 0 0 0 0 0 0 0 0 0 0 0 0 0 3 5 7 7 7 7 6 4 0 0 32 33 33 33 34 0 0 0 0 0 0 0 0 32 33 33 33 34 0 0 0 0 0 0 0 0 0 0 0 0 0 0 0 0 0 0 0 0 0 0 0 0 0 0 0 0 0 0 0 0 0 1 30 2 0 3 31 4 0 3 5 6 4 0 0 0 0 0 0 0 0 0 0 0 0
31 31 31 31 31 31 31 31 31 4 0 0 0 0 3 31 5 6 31 4 0 0 0 0 0 35 36 36 30 30 30 30 30 30 30 30 30 30 6 19 17 17 10 0 0 0 0 0 0 0 0 0 0 0 0 0 0 0 0 0 0 0 0 0 0 0 0 0 32 33 33 33 34 0 0 0 0 0 0 0 0 0 0 0 0 0 0 0 0 0 0 0 0 0 0 0 3 31 4 0 3 31 4 0 3 5 6 4 0 0 0 0 0 0 0 0 0 0 0 0
31 31 31 31 31 31 31 31 31 4 0 0 0 0 3 31 5 6 31 4 0 0 0 0 0 0 0 3 5 7 7 7 7 7 7 7 7 7 6 4 0 0 0 0 38 0 0 0 0 0 0 0 0 0 0 0 0 0 0 0 0 0 0 0 0 0 0 0 0 0 0 0 0 0 0 0 0 0 0 0 0 0 0 0 0 0 0 0 0 0 0 1 30 30 2 0 3 31 4 0 3 31 4 0 3 5 6 4 0 0 0 0 0 0 0 0 0 0 0 0
31 31 31 31 31 31 31 31 31 4 0 0 0 0 3 31 5 6 31 4 0 0 0 0 0 0 0 3 5 7 7 7 7 7 7 7 7 7 6 4 32 33 34 0 0 0 0 0 0 0 0 0 0 0 0 0 0 0 0 0 0 0 0 0 0 0 0 0 0 0 0 0 0 0 0 0 0 0 0 0 0 0 0 0 0 32 33 34 0 0 0 3 5 6 4 0 3 31 4 0 3 31 4 0 3 5 7 36 37 0 0 0 0 0 0 0 32 33 33 33