100
8
0 0 0 0 0 0 0 0 0 0 0 0 0 0 0 0 0 0 0 0 0 0 0 0 0 0 0 0 0 0 0 0 0 0 0 0 0 0 0 0 0 0 0 0 0 0 0 0 0 0 0 0 0 0 0 0 0 0 0 0 0 0 0 0 0 0 0 0 0 0 0 0 0 0 0 0 0 0 0 0 0 0 0 0 0 0 0 0 0 0 0 0 0 0 0 0 0 0 0 0
0 0 0 0 0 0 0 0 0 0 0 0 0 0 0 0 0 0 0 0 0 0 0 0 0 0 0 0 0 0 0 0 0 0 20 0 0 0 0 0 0 0 0 0 0 0 0 0 0 0 0 0 0 0 0 0 0 0 0 0 0 0 0 0 0 0 0 0 0 0 0 0 0 0 0 0 0 0 0 0 0 0 0 0 0 0 0 0 0 0 0 0 0 20 0 0 0 0 0 0
0 0 0 0 10 0 0 0 0 0 0 0 0 0 0 0 0 0 0 0 0 0 0 0 0 0 0 0 0 0 0 0 0 0 14 0 0 0 0 0 0 0 0 0 0 0 0 0 0 0 0 0 0 0 0 0 0 0 0 0 0 0 0 0 0 0 0 0 0 0 0 0 0 0 0 0 0 0 0 0 0 0 0 0 0 0 0 0 0 0 0 0 0 14 0 0 0 0 0 0
0 0 0 23 25 0 0 0 0 0 0 0 0 0 0 0 0 0 0 0 0 0 0 0 0 0 0 0 0 0 0 0 0 23 24 24 25 0 0 0 0 0 11 0 0 0 0 0 0 0 0 0 0 0 0 0 0 0 0 0 0 0 0 0 0 0 0 0 20 0 0 0 0 0 0 0 0 0 0 0 0 0 0 0 0 0 0 0 0 0 0 0 0 14 0 0 0 0 10 0
0 0 0 0 0 0 0 0 20 0 0 0 0 0 0 0 0 0 0 0 0 0 11 0 0 0 9 0 0 0 0 20 0 0 0 0 0 0 0 0 0 1 21 2 0 0 0 0 0 0 0 0 0 0 0 0 0 0 0 0 0 0 0 0 0 0 0 0 14 0 0 0 0 0 0 0 0 0 0 0 20 0 0 0 0 0 0 0 0 0 0 0 0 14 0 0 0 1 21 21
0 0 0 0 0 0 0 0 14 0 0 0 0 0 0 0 0 0 1 21 21 21 21 21 21 21 21 21 21 2 0 14 0 0 0 0 0 0 20 0 0 3 22 4 0 0 0 0 0 0 0 0 0 0 0 0 0 0 0 23 24 24 25 0 0 0 0 0 14 0 0 0 0 0 0 0 0 0 0 0 14 0 0 0 0 0 0 0 0 0 0 0 0 14 0 0 1 21 22 22
0 9 11 11 0 0 0 0 14 0 0 9 10 0 0 0 0 0 3 22 22 22 22 22 22 22 22 22 22 4 0 14 0 0 0 0 0 0 14 0 0 3 22 4 1 21 2 0 0 0 0 0 0 1 21 2 0 0 20 0 0 0 0 0 1 21 2 10 14 1 21 2 0 0 0 10 9 0 0 0 14 0 0 0 11 11 9 0 0 20 1 21 21 21 21 21 21 22 22 22
21 21 21 21 21 21 21 21 21 21 21 21 21 21 21 21 2 0 3 22 22 22 22 22 22 22 22 22 22 4 0 14 0 0 0 0 20 0 14 0 0 3 22 4 3 22 21 21 21 21 21 21 21 21 22 4 0 0 14 0 0 20 0 0 1 21 21 21 21 21 21 2 0 1 21 21 21 21 2 0 14 0 1 21 21 21 21 2 0 14 26 18 22 22 22 22 22 22 22 22