100
8
0 0 0 0 0 0 0 0 0 0 0 0 0 0 0 0 0 0 0 0 0 0 0 0 0 0 0 0 0 0 0 0 0 0 0 0 0 0 0 0 0 0 0 0 0 0 0 0 0 0 0 0 0 0 0 0 0 0 0 0 0 0 0 0 0 0 0 0 0 0 0 0 0 0 0 0 0 0 0 0 0 0 0 0 0 0 0 0 0 0 0 0 0 0 0 0 0 3 31 31
0 0 0 0 0 0 0 0 0 0 0 0 0 0 0 0 0 0 0 0 0 0 0 0 0 0 0 0 0 0 0 0 0 0 15 0 0 0 0 0 0 0 0 0 0 0 0 0 0 0 0 0 0 0 0 0 0 0 0 0 0 0 0 0 0 0 0 0 0 0 0 0 0 0 0 0 0 0 0 0 0 0 0 0 0 0 0 0 0 0 0 0 0 15 0 0 0 9 17 17
0 0 0 0 12 0 0 0 0 0 0 0 0 0 0 0 0 0 0 0 0 0 0 0 0 0 0 0 0 0 0 0 0 0 14 20 0 0 0 0 0 0 0 0 0 0 0 0 0 0 0 0 0 0 0 0 0 0 0 0 0 0 0 0 0 0 0 0 0 0 0 0 0 0 0 0 0 0 0 0 0 0 0 0 0 0 0 0 0 0 0 0 0 16 0 0 0 0 0 0
0 0 0 32 34 0 0 0 0 0 0 0 0 0 0 0 0 0 0 0 0 0 0 0 0 0 0 0 0 0 0 0 0 32 33 33 34 0 0 0 0 0 13 0 0 0 0 0 0 0 0 15 0 0 0 0 0 0 0 0 0 0 0 0 0 0 0 0 15 0 0 0 0 0 0 0 0 0 0 0 0 0 0 0 0 0 0 0 0 0 0 0 0 16 0 0 0 0 12 0
0 0 0 0 0 0 0 0 15 0 0 0 0 0 0 0 0 0 0 0 0 0 13 0 0 0 11 0 0 0 0 15 0 0 0 0 0 0 0 0 0 1 30 2 0 0 0 0 0 0 0 16 0 0 0 0 0 0 0 0 0 0 0 0 0 0 0 0 16 0 0 0 0 0 0 0 0 0 0 0 15 0 0 0 0 0 0 0 0 0 0 0 0 16 0 0 0 1 30 30
0 0 0 0 0 0 0 0 16 0 0 0 0 0 0 0 0 0 1 30 30 30 30 30 30 30 30 30 30 30 2 16 0 0 0 0 0 0 15 0 0 3 31 4 0 0 0 11 0 0 0 14 0 0 0 0 0 0 0 32 33 33 34 0 0 0 0 0 16 0 0 0 0 0 0 0 0 0 0 0 16 0 0 0 0 0 0 0 0 0 0 0 0 14 0 0 1 30 6 31
0 11 13 13 0 0 0 0 14 0 0 11 12 0 0 0 0 0 3 31 31 31 31 31 31 31 31 31 31 31 4 16 0 0 0 0 0 0 16 0 0 3 31 4 1 30 30 30 30 30 30 30 30 30 30 30 2 0 15 0 0 0 0 0 0 0 0 12 14 0 0 0 0 0 0 12 11 0 0 0 16 0 0 0 13 13 11 0 0 15 1 30 30 30 30 30 30 6 31 31
30 30 30 30 30 30 30 30 30 30 30 30 30 30 30 30 2 0 3 31 31 31 31 31 31 31 31 31 31 31 4 16 0 0 0 0 15 0 16 0 0 3 31 4 3 31 31 31 31 31 31 31 31 31 31 31 4 0 16 0 0 15 0 0 1 30 30 30 30 30 30 2 0 1 30 30 30 30 2 0 16 0 1 30 30 30 30 2 0 16 9 18 31 31 31 31 31 31 31 31